CASSQGLAGDEQF	EIYKRWII
CASSEVGKGNQPQHF	LPRRSGAAGA
CASSLSTSSRNYGYTF	LPRRSGAAGA
CASTQEPGELFF	GLCTLVAML
CASGPGSSYNEQFF	GILGFVFTL
CASRKGGSSYNEQFF	NLVPMVATV
CASSIDLRGYQNIQYF	EPLPQGQLTAY
CSVETGQTQETQYF	GILGFVFTL
CASSPTGQAHEQYF	LPRRSGAAGA
CASSIFSGANVLTF	GILGFVFTL
CASRNRGDYAEQFF	HGIRNASFI
CASSERGTANTEAFF	RFYKTLRAEQASQ
CASSSGTINTGELF	GLCTLVAML
CASSLAGTSYYNEQFF	GLCTLVAML
CASSAPVTDTQYF	RFYKTLRAEQASQ
CASRLRRAGGDRELFF	GLCTLVAML
CASSPGVSVEQYF	LPRRSGAAGA
CASSLGTGGNQPQHF	LPRRSGAAGA
CASSEGKEVFF	ASNENMETM
CASSPSAGDYEQYF	LLWNGPMAV
CASSDGTAPYEQYF	TPRVTGGGAM
CSARDRVGNTIYF	GLCTLVAML
CASSLGQGYYGYTF	LPRRSGAAGA
CASSRPTGGNYGYTF	LPRRSGAAGA
CASSLMGRGPNTGELLF	GLCTLVAML
CASSAQFLFASGYTF	EAAGIGILTV
CASSPGTVAYEQYF	NLVPMVATV
CASSLLSGGSYNEQFF	NLVPMVATV
CASSLAVLSSYNEQF	RAKFKQLL
CASSLMTGELF	HPVGEADYFEY
